SSSSSSSSSSSSSSSSSSSSSSSSSSSSSSSSSSSSSSSSSSSSSSSSSSSSSSSSSSSSSSSSSSSSSSSSSSSSSSSSSSSSSSSSSSSSSSSSSSSSSSSSSSSSSSSSSSSSSSSSSSSSSSSSSSSSSSSSSSSSSSSSSSSSSSSSSSSSSSSSSSSSSSSSSSSSSSSSSSSSSSSSSSSSSSSSSSSSSSSSSSSSSSSSSSSSSSSSSSSSSSSSSSSSSSSSSSSSSSSSSSSSSSSSSSSSSSSSSSSSSSSSSSSSSSSSSSSSSSSSSSSSSSSSSSSSSSSSSSSSSSSSSSSSSSSSSSSSSSSSSSSSSSSSSSSSSSSSSSSSSSSSSSSSSSSSSSSSSSSSSSSSSSSSSSSSSSSSSSSSSSSSSSSSSSSSSSSSSSSSSS"\n"
KKKKKKKKKKKKKKKKKKKKKKKKKKKKKKKKKKKKKKKKKKKKKKKKKKKKKKKKKKKKKKKKKKKKKKKKKKKKKKKKKKKKKKKKKKKKKKKKKKKKKKKKKKKKKKKKKKKKKKKKKKKKKKKKKKKKKKKKKKKKKKKKKKKKKKKKKKKKKKKKKKKKKKKKKKKKKKKKKKKKKKKKKKKKKKKKKKKKKKKKKKKKKKKKKKKKKKKKKKKKKKKKKKKKKKKKKKKKKKKKKKKKKKKKKKKKKKKKKKKKKKKKKKKKKKKKKKKKKKKKKKKKKKKKKKKKKKKKKKKKKKKKKKKKKKKKKKKKKKKKKKKKKKKKKKKKKKKKKKKKKKKKKKKKKKKKKKKKKKKKKKKKKKKKKKKKKKKKKKKKKKKKKKKKKKKKKKKKKKKKSS"\n"
S...............................................................................................................................................................................................................................................................................................................................................................................................................1S"\n"
S...............................................................................................................................................................................................................................................................................................................................................................................................................1S"\n"
S...............................................................................................................................................................................................................................................................................................................................................................................................................1S"\n"
S...................................................G...........................................................................................................................................................................................................................................................................................................................................................1S"\n"
S...............................................................................................................................................................................................................................................................................................................................................................................................................1S"\n"
S...............................................................................................................................................................................................................................................................................................................................................................................................................1S"\n"
S...............................................................................................................................................................................................................................................................................................................................................................................................................1S"\n"
S...............................................................................................................................................................................................................................................................................................................................................................................................................1S"\n"
S...............................................................................................................................................................................................................................................................................................................................................................................................................1S"\n"
S...............................................................................................................................................................................................................................................................................................................................................................................................................1S"\n"
S...............................................................................................................................................................................................................................................................................................................................................................................................................1S"\n"
S...............................................................................................................................................................................................................................................................................................................................................................................................................1S"\n"
S...............................................................................................................................................................................................................................................................................................................................................................................................................1S"\n"
S111........1..............1.............1..............1.............1..............1.............1..............1.............1..............1.............1..............1.............1..............1.............1..............1.............1..............1.............1..............1.............1..............1.............1..............1.............1..............1.....................1111S"\n"
S...............................................................................................................................................................................................................................................................................................................................................................................................................1S"\n"
S..................................................................................................................................................................................................................G............................................................................................................................................................................................1S"\n"
S...............................................................................................................................................................................................................................................................................................................................................................................................................1S"\n"
S...............................................................................................................................................................................................................................................................................................................................................................................................................1S"\n"
S...............................................................................................................................................................................................................................................................................................................................................................................................................1S"\n"
S...............................................................................................................................................................................................................................................................................................................................................................................................................1S"\n"
S11111........1..............1.............1..............1.............1..............1.............1..............1.............1..............1.............1..............1.............1..............1.............1..............1.............1..............1.............1..............1.............1..............1.............1..............1.............1..............1...................1111S"\n"
S...............................................................................................................................................................................................................................................................................................................................................................................................................1S"\n"
S.....................................................................................................................................................................................................................................................................................................................................1.........................................................................1S"\n"
S............................................................................................................1...............................................................................1.....................................................1............................................................................................................................................................1S"\n
S.................................................................................................................................................................................................................................................................................................................G.............................................................................................1S"\n"
S...............................................................................................................................................................................................................................................................................................................................................................................................................1S"\n"
S........................................................................................................................................................................................................................1..................................................................................................................................1..................1...............1.............1111S"\n"
S111.........1...............1............1..........1..........................................................................................................................................................................................................................................................................................................................................................1S"\n"
S...............................................................................................................................................................................................................................................................................................................................................................................................................1S"\n"
S...................1..................................................................................111.......................................................................................111...........................................11.........................................................................................11......11......................................G...............1.....1S"\n"
S.......................................................................................1111...1111....111........E.........................................................................E....111.....111111....................111111......11.....E..............................................................................E....11....................................................................1S"\n"
S......................................................................................................11111111111SS1111111111111SS11111111111111SS1111111111111111111SS111111111111111SS11111111111...........................................11111111111SS1111111111111SS11111111111111SS1111111111111111111SS111111111111111SS11111111111....................................................................1S"\n"
S...............................................................................................................................................................................................................................................................................................................................................................................................................1S"\n"
S...............................................................................................................................................................................................................................................................................................................................................................................................................1S"\n"
S111..........1...............1............1..........1...........1.......................................................................................................................................................................................................................................................................................1...........1...............1...........1..........1111S"\n"
S.............................................................................1...............................................................................................................G..........................1......................................................................................................................................................................................1S"\n"
S...............................................................................................................................................................................................................................................................................................................................................................................................................1S"\n"
S...............................................................................................................................................................................................................................................................................................................................................................................................................1S"\n"
S...............................................................................................................................................................................................................................................................................................................................................................................................................1S"\n"
S...............................................................................................................................................................................................................................................................................................................................................................................................................1S"\n"
S.P.............................................................................................................................................................................................................................................................................................................................................................................................................1S"\n"
S111111...........1.................1.................1......................111...............1.........1.................1.................1.................1.................1.................1....................111....................1.................1.................1.................1.................1.................1.................1.................1.................1................1S"\n"
S..................................................................1............................................................................................................................................................................................................................................................................................................................................1S"\n"
S...............................................................................................................................................................................................................................................................................................................................................................................................................1S"\n"
S..........................................................................................................................................................................................................11.........................11.....................................................................................................................................................................1..1S"\n"
S...............................................................................................................................................................................................................................................................................................................................................................................................................1S"\n"
S...............................................................................................................................................................................................................................................................................................................................................................................................................1S"\n"
S......................................................................11SSSSSSSSSSS11..........................................................................................................................................................................................................................................................................................................................1S"\n"
S11................11................11................11...............1SSSSSSSSSSS1.................11................11................11................11................11................11................11SSSSSSSSSSS11................11................11................11................11................11................11................11................11..........11...................1S"\n"
S.......................................................................1111111111111.............11................................................................................................11.............1SSSSSSSSSSS1.............11.................................................................................................................................................................1S"\n"
S...................................................................111111111111111111111......................................................................................................................111111111111111111111....................................................................................................................................................................111111111S"\n"
S.......1..................................11...................................................................................11....................................................11...................................................................................11......................................................11.................................11........................................1S"\n"
S....................................................................................................................................................................................................................................................................................................................................................................................................11.........1S"\n"
S...................................................G...........................................................................................................................................................................................................................................................................................................................................................1S"\n"
S...............................................................................................................................................................................................................................................................................................................................................................................................................1S"\n"
S....E.....................................................................................................................................................................................................................................................................................................................................................................................E....................1S"\n"
SSSSSSSSSSSS1SSSSSSSSSSSSSS11SSSSSSSSS11SSSSSSSSS11SSSSSSSSSSSSSSSSSSSSSSSSSSSSSSSSSSSSSSSSSS11SSSSSSSSSSSSSSSSSSSSSSSSSSS11SSSSSSSSS11SSSSSSSSSSSSSSSSSSSSSSSSSSSSSSSSSSSSSSSS11SSSSSSSSSSS11SSSSSSSSSSS11SSSSSSSSSSSSSSSSSSSSSSSSSSSSS11SSSSSSSSSSSSSSSSSSSSSSSSSS11SSSSSSSSSSSSS11SSSSSSSSSSSSSSSSSSSSSSSSSSSSSSSSSSSSSSS11SSSSSSSSSSS11SSSSSSSSSSSSSSSSSSSSSSSSSSSSSSSSSSSSSSSSSSSSSSSSSS11SSSSSSSSSSSSSSSSS1S"\n"
SSSSSSSSSSSSSSSSSSSSSSSSSSSSSSSSSSSSSSSSSSSSSSSSSSSSSSSSSSSSSSSSSSSSSSSSSSSSSSSSSSSSSSSSSSSSSSSSSSSSSSSSSSSSSSSSSSSSSSSSSSSSSSSSSSSSSSSSSSSSSSSSSSSSSSSSSSSSSSSSSSSSSSSSSSSSSSSSSSSSSSSSSSSSSSSSSSSSSSSSSSSSSSSSSSSSSSSSSSSSSSSSSSSSSSSSSSSSSSSSSSSSSSSSSSSSSSSSSSSSSSSSSSSSSSSSSSSSSSSSSSSSSSSSSSSSSSSSSSSSSSSSSSSSSSSSSSSSSSSSSSSSSSSSSSSSSSSSSSSSSSSSSSSSSSSSSSSSSSSSSSSSSSSSSSSSSSSSSSSSSSSSSSSSSSSSSSSSSSSSSS"\n"
